XXXXXXXXXXXXXXXXXXXXXXXXXXXXX
XXXXXXXXXXXXX   XXXXXXXXXXXXX
X X X X X X   X   X X X X X X
XE            F         c  RX
X X X X X X   X   X X X X X X
XXXXXXXXXXXXX   XXXXXXXXXXXXX
XXXXXXXXXXXXXXXXXXXXXXXXXXXXX
