XXXXXXXXXXXXXXXXXXXXX
X         X X   XXXXX
X X XXXXX X XXX X   X
X X X     X       F X
XNX X X XXX XXX X   X
XXX   X X X   X XXXXX
X X XXX X XXX XXXXXXX
X X X       X   XXXXX
X X X XXXXXXXXX XXXXX
X   X X     X   XXXXX
X XXX X XXX X X XXXXX
X X     XRX     XXXXX
X XXXXXXX XXXXX XXXXX
X   X   X       XXXXX
X X X X X XXX X XXXXX
X X   X   X   X XXXXX
XXXXXXXXXXXXXXXXXXXXX
