XXXXX
XSXFX
X X X
X  RX
XXXXX
