XXXXXXX
XS  XXX
X X XXX
X     X
XXX X X
XXX  bX
XXXXXXX
