XXXXXXXXXXXXXXX
X      X      X
X XXXXXXXXXXX X
X X         X X
X XXX XNX XXX X
X     X X     X
X XX XX XX XX X
X  X X   X X  X
XX   XX XX   XX
XXXX       XXXX
X X  XX XX  X X
X   XX   XX   X
X XR   X   FX X
X XX XXXXX XX X
X      X      X
XXXXXXXXXXXXXXX
