XXXXXXXXXXXXXXX
XXXXXXXSXXXXXXX
XXXXXXX XXXXXXX
XXXXXXX XXXXXXX
XXXXX     XXXXX
XX           XX
X             X
X             X
X             X
X      R      X
X             X
X             X
X             X
XX           XX
XXXXX     XXXXX
XXXXXXX XXXXXXX
XXXXXXX    XXXX
XXXXXXXXXX XXXX
XXXX     X XXXX
XXXX XXX X XXXX
XXXX XF  X XXXX
XXXX XXXXX XXXX
XXXX       XXXX
XXXXXXXXXXXXXXX
