XXXXXXXXXXX
XX   X   XX
X F       X
XX   S   XX
X         X
X  XXXXX  X
XX  XXX  XX
XXX  X  XXX
XXXX   XXXX
XXXXX XXXXX
XXXXXRXXXXX
XXXXXXXXXXX
