XXXXX
XE  X
XX XX
XR  X
XX  X
XXXFX
X   X
XXXXX
